%%%%%%%%%%%%%%%%
%   P          %
%G     %  G    %
%....  % ..... %
%%%%%%%%%%%%%%%%