%%%%%%%%
%   P G%
%G     %
%....  %
%%%%%%%%