1111111111111111111111111111111111111111
1                                      1
1                                      1
1    11111111111        11111111111    1
1    1                            1    1
1    1                            1    1
1    1                            1    1
1    1     1111111     1111111    1    1
1    1     1                 1    1    1
1    1     1                 1    1    1
1          1     1     1     1         1
1          1     1     1     1         1
1          3     1     1               1
1          1     1     1     1         1
1    1     1        P  3     1    1    1
1    1     1     ............1    1    1
1    1     111111.......111111    1    1
1                                 1    1
1    1                            1    1
1      1111111111111111111111111111    1
1111                                   1
1  1111111111111111                    1
1                                      1
1111111111111111111111111111111111111111