1111111111111111111
1......1...1......1
1....1.1.3..2.....1
1....1.3.311......1
1..P.1............1
1111111111111111111