1111111111111111
1..............1
1..3.111..11...1
1.............1
1..............1
1....1.....1...1
1....1...P.1...1
1....1.....1...1
1..............1
1111111111111111