1111111111111111
1..............1
1..............1
1.....1....1...1
1...3.1....13..1
1.....1....1...1
1.....1..P.1...1
1..............1
1....3.........1
1111111111111111