1111111111111111111111111111111111111111
1......................................1
1......................................1
1....11111111111........11111111111....1
1....1............................1....1
1....1............................1....1
1....1............................1....1
1....1.....1111111.....1111111....1....1
1....1.....1.................1....1....1
1....1.....1.....3.....3.....1....1....1
1..........1.....11.2.11.....1.........1
1..........1.....1.....1.....1.........1
1................1.....1...............1
1..........1.....1133311.....1.........1
1....1.....1.................1....1....1
1....1.....1.................1....1....1
1....1.....111111.......111111....1....1
1..1.1............................1....1
1....1............................1.1111
1111..31111111111111111111111111111....1
1..333.................................1
1.P..11111111111111....................1
1......................................1
1111111111111111111111111111111111111111