1111111111111111
1..............1
1..1...........1
1..1..1....1...1
1....31....13..1
1.....1....1...1
1....11..P.1...1
1..1...........1
1..1...........1
1111111111111111