111111111
1.......1
1.......1
1.......1
1....3..1
1.......1
1P......1
1.......1
1.......1
111111111